16 16
0 0 0 0 0 0 0 0 0 0 0 0 0 0 0 0
0 5 0 5 0 0 0 0 0 0 0 0 5 0 5 0
0 5 0 5 0 5 0 0 0 0 5 0 5 0 5 0
0 5 0 5 0 5 0 0 0 0 5 0 5 0 5 0
0 0 0 0 0 5 10 10 10 10 5 0 0 0 0 0
0 0 0 0 0 5 0 0 0 0 5 0 0 0 0 0
0 0 0 0 0 0 0 0 0 0 0 0 0 0 0 0
10 0 5 5 0 5 0 0 0 0 5 0 5 5 0 10
0 0 0 0 0 0 0 0 0 0 0 0 0 0 0 0
0 0 0 0 0 5 0 0 0 0 5 0 0 0 0 0
0 5 5 5 0 5 5 5 5 5 5 0 5 5 5 0
0 0 0 0 0 5 0 0 0 0 5 0 0 0 0 0
0 5 0 5 0 5 0 0 0 0 5 0 5 0 5 0
0 5 0 5 0 0 0 0 0 0 0 0 5 0 5 0
0 5 0 5 0 0 5 4 4 5 0 0 5 0 5 0
0 0 0 0 0 0 5 14 0 5 0 0 0 0 0 0