16 16
0 0 0 5 0 0 0 0 0 0 0 0 0 0 0 0
0 0 0 5 0 0 0 0 0 0 0 0 10 10 10 10
0 0 0 5 0 0 0 0 0 0 0 0 5 0 0 0
10 10 10 10 0 0 0 0 0 0 0 0 5 0 0 0
0 0 0 0 0 0 0 0 0 0 0 0 10 10 10 10
0 0 0 0 0 0 0 0 0 0 0 0 0 0 0 0
10 10 10 10 0 0 0 0 0 0 0 0 0 0 0 0
0 0 0 5 0 0 0 0 0 0 0 0 10 10 10 10
0 0 0 5 0 0 0 0 0 0 0 0 5 0 0 0
10 10 10 10 0 0 0 0 0 0 0 0 5 0 0 0
0 0 0 0 0 0 0 0 0 0 0 0 10 10 10 10
0 0 0 0 0 0 0 0 0 0 0 0 0 0 0 0
10 10 10 10 0 0 0 0 0 0 0 0 0 0 0 0
0 0 0 5 0 0 0 0 0 0 0 0 10 10 10 10
0 0 0 5 0 0 0 0 0 0 0 0 5 0 0 0
10 10 10 10 0 0 0 0 0 0 0 0 5 0 0 14
