16 16
15 0 0 5 0 0 0 15 0 0 0 0 0 0 0 0
0 0 0 5 0 0 0 0 0 0 0 0 10 10 10 5
0 0 0 5 0 0 0 0 0 0 15 0 5 0 0 0
5 10 10 10 0 0 0 0 0 0 0 0 5 15 0 0
0 0 0 0 0 0 0 0 0 0 0 0 10 10 10 5
0 0 0 0 0 0 0 0 0 0 0 0 0 0 0 0
5 10 10 10 0 0 0 0 0 0 0 0 0 0 0 0
0 15 0 5 0 0 0 0 0 0 0 0 10 10 10 5
0 0 0 5 0 0 0 0 0 0 0 0 5 0 15 0
5 10 10 10 0 0 0 0 0 0 0 0 5 0 0 0
0 0 0 0 0 0 0 0 0 0 0 0 10 10 10 5
0 0 0 0 0 0 0 0 0 0 0 0 0 0 0 0
5 10 10 10 0 0 0 0 0 0 0 0 0 0 0 0
0 15 0 5 0 0 0 0 0 0 0 0 10 10 10 5
0 0 0 5 0 0 0 0 0 0 0 0 5 0 0 0
5 10 10 10 0 0 0 0 0 0 0 0 5 0 0 14
